###########
#         #
# $...$   #
#    ## @ #
# #  # #  #
#       $ #
###########
