###############
#             #
# $..   ..$   #
# #.#   #.#   #
# #.# @ #.#   #
#     $ $ $   #
#   # # # #   #
#   #         #
#   #   $   # #
#   #   #   # #
#   #   .   # #
#   ###########
#####