###################
#####   ###########
#####$ $###########
#####   ###########
###      ##########
### #$## ##########
#   # ## #####  ..#
# $             ..#
##### ### # ##  ..#
#####     #########
###################