#######
###  ##
###$ ##
#  !  #
#  !  #
#  !@##
###! ##
###.###
#######