#######
#     #
#.$@  #
#.#   #
# $   #
# .   #
#######