###########
#         #
# $...$   #
# # # # @ #
# # # #   #
#       $ #
###########
