#########
#   #####
# # #   #
# $   $ #
#..#$#$##
#.@$   ##
#..  ####
#########